20
GGGGGGGGGGGGGGGGGGGG
GEPPPPGGGGTGGGGTPPPG
GGGGGPGGGGTGGGGGPGPG
GGGGGPTGGGGGGGTGPGPG
GGGGGPPPPPPPPPPPPGPG
GGTGGGGGGGGGGGGGGGPG
GPPPPPPPPPPPPPPPPPPG
GPGGGGGTGGGGGGGGGGGG
GPGGGGGTGGGGGGGGGGGG
GPPPPPPPPPPPPPPPPPPG
GGGGTTGGGGGGGGGGGGPG
GGGGGGGGGGGGGGGGTTPG
GPPPPPPPPPPPPPPPPPPG
GPGGGGGGGGGGGGTGGGGG
GPGGTGGGGGGTGGGGGGGG
GPPPPPPPPPPPPPPPPPPG
GGGGGGGGGGGGGGGGTGPG
GGGGGGGTGGGGTGGGGGPG
GSPPPPPPPPPPPPPPPPPG
GGGGGGGGGGGGGGGGGGGG