19
GGGGGGGGGGGGGGGGGG
GGGGGGGGGGGGGGGGGG
GGGSPPPPPPPPPPPPGG
GGGGGGGGGGGGGGTPGG
GGGGGGGGGGGGGGGPGG
GGGPPPPPPPPPPGGPGG
GGGPTGGGGGGTPGGPGG
GGGPGGGGGGGGPGGPGG
GGGPGGPPPPGGPGGPGG
GGGPGGPTTPGGPGGPGG
GGGPGGPGGEGGPGGPGG
GGGPGGPGGGGGPGGPGG
GGGPGGPTGGGTPGGPGG
GGGPGGPPPPPPPGGPGG
GGGPGGGGGGGGGGGPGG
GGGPTGGGGGGGGGTPGG
GGGPPPPPPPPPPPPPGG
GGGGGGGGGGGGGGGGGG
GGGGGGGGGGGGGGGGGG