15
GGGGGGGG
GSGPPPEG
GPTPGGGG
GPTPGGGG
GPGPPPPG
GPGGGTPG
GPGGGTPG
GPGPPPPG
GPTPGGGG
GPTPGGGG
GPGPPPPG
GPGGGTPG
GPGGGTPG
GPPPPPPG
GGGGGGGG