5
GGGGGGGGGGGGGGG
GGGGGGGGTGTGTGG
GSPPPPPPPPPPPEG
GGGGGGGTGTGTGGG
GGGGGGGGGGGGGGG