17
GGGGGGGGGGGGGGG
GGGGGGGGGGGGGGG
GGGGGGGGGGGGGGG
GGGGGGGTGGGGGGG
GGPPPPGTGPPPPGG
GGPTGPPPPPGTPGG
GGPGGGTGTGGGPGG
GGPPPPPGPPPPPGG
GGGGGGPGPGGGGGG
GGGGPPPGPPPGGGG
GTGGPTGGGTPGGTG
GGGGPPSGEPPGGGG
GGGGGGGGGGGGGGG
GGGGGGGTGGGGGGG
GGGGGGGGGGGGGGG
GGGGGGGGGGGGGGG
GGGGGGGGGGGGGGG