6
GGGGGGGGGGGGGGGGG
GGPPPPPGGGPPPPPGG
GGPGGGPPPPPGGGPGG
GGPGGTGTTTGTGGPGG
GGPPPPPEGSPPPPPGG
GGGGGGGGGGGGGGGGG