12
GGGGGGGGGGGG
GGGGGGGGGGGG
GSPPPPPPPPGG
GGTGGGTGGPGG
GGGGGGPPPPGG
GGGGGGPTGGGG
GGGGGGPPPPTG
GGGGGGGGGPGG
GGTGGGGGTPGG
GEPPPPPPPPGG
GGGGGGGGGGGG
GGGGGGGGGGGG

3 2,3 6,5 7,6 10,8 2,8 8
